
ตลอด	ตะลอน
หงหยก	หงษ์หยก
สุคุณา	สุขุนา
สุมนรัฐ	สุมนรัตน์
พง	พงศ์
กระเหลี่ยง	กะเหรี่ยง
สุมนรัฐ	สุมนรัตน์
เฉลิมพงศ์	เฉลิมพงษ์
สุคุณา	สุขุนา
ศรีบรรพฤษ	ศรีบรรพต
พง	พงศ์
ลองฮะ	ชมฮะ
กะเหลี่ยง	กะเหรี่ยง
หกสิบหก	66
นายวิชิระแขทอง	นายวชิระ แขทอง
สิบเก้า	29
นายธนาวุฒิถาวรพราม	นายธนาวุฒิถาวร พราหมณ์
ห้า	5
นางสาวนิรนาศศรีพุทธา	นางสาวนิรนาท ศรีพุทธา
สิบ	10
นางระเวง	นางละเวง
ท่าแคร์	ท่าแค
โรงพยาบาลศิริกิจ	โรงพยาบาลสิริกิติ์
อภิษฎเวชาชีว	อภิสิทธิ์เวชชาชีวะ
แบงค์	แบงก์
<Mark>
ศาล	ศิลปศาสตร์
อิลอนมัส	อีลอนมัสก์
ปพ	ปพ.
เมาติฟังก์ชัน	มัลติฟังก์ชัน
พุ้งเฟื้อง	ฟุ้งเฟื่อง
โคจิฮากิวดะ	โคอิจิฮากิอูดะ
บ้านดู	บ้านดู่
<MARK>	()
สี่	4
บต	อบต.
สองร้อย	200
นายกรมตี	นายกรัฐมนตรี
เสีย	เสี่ย
สุมนรัฐ	สุมนรัตน์
เฉลิมพงศ์	เฉลิมพงษ์
สุคุณา	สุขุนา
คลองชมธาน	คลองชลประทาน
พง	พงศ์
ศรีบรรพฤษ	ศรีบรรพต
จู่	จู่ๆ
คุ้มหลัง	คุ้มหรั่ง
รัฐมนูล	รัฐธรรมนูญ
ประจีนบุรี	ปราจีนบุรี
มะลิวัน	มะลิวัลย์
สปพ	สปพ.
สบค	ศบค.
หนองหายใต้	หนองไฮใต้
ไตรตรึง	ไตรตรึงษ์
รัตนโกศิลป์	รัตนโกสินทร์
ริมเจริญรัฐ	ลิ้มเจริณรัตน์
เจ้าที่	เจ้าหน้าที่
พัก	พรรค
ยกย้าย	โยกย้าย
พบ	พลาก
บังละมุง	บางละมุง
เทียนสูตร	เธียรสูตร
แบ็คโฮล	แบ็กโฮ
บ้านคำบอล	บ้านคำบอน
อำเภอท่าลี	อำเภอท่าลี่
เล็บขวน	เล็บข่วน
ตายขาด	ตายคา
รอยขีดขวด	รอยขีดข่วน
ห้วยกระเจ้า	ห้วยกระเจา
เกาะโพ	เกาะโพธิ์
มีดพระ	มีดพร้า
นี้	เนี้ย
ฤหัส	พฤหัส
วิลัยพร	วิไลพร
รณรงค์	รณณรงค์
แก้วเพชร	แก้วเพ็ชร์
ซอยชายพรวิถี	ซอยชัยพรวิถี
ตำบลหนองปลือ	ตำบลหนองปรือ
อำเภอบาลังมุง	อำเภอบางละมุง
นางชวีวัน	นางฉวีวรรณ
นางมานิด	นางมานิตย์
หนองหงษ์	หนองหงส์
นางมานิด	นางมานิตย์
เต็มปักศรี	เต็มปักษี
สภ.นหงษ์	สภ.หนองหงส์
ถนนสุขุมวิทย์	ถนนสุขุมวิท
ธิรเดช	ธีรเดช
วงเฉลิมวัด	วงศ์เฉลิมวัฒน์
โค้ทอง	โคตรทอง
จังหวัดเชียงบราย	จังหวัดเชียงราย
ปากใต้	ปักษ์ใต้
ก็	ออก
แถลงการ	แถลงการณ์
ปรินา	ปารีณา
นาย	ทนาย
อนัญชัย	อนันต์ชัย
นาย	ทนาย
อนัญ	อนันต์
สุภาษา	สุพรรษา
ภาษา	พรรษา
พันธุ์ตำรวจเอก	พันตำรวจเอก
อลงกร	อลงกรณ์
สิริสงคราม	ศิริสงคราม
อนันต	อนันต์
ชัย	ไชย
สุมนรัฐ	สุมนรัตน์
รัตนชัด	รัตนฉัตร
แสงหยกตรการ	แสงหยกตระการ
รัชนีกร	รชนิกร
รัตนชัด	รัตนฉัตร
รัชนีกร	รชนิกร
มณีรัฐ	มณีรัตน์
รัชนีกร	รชนิกร
มณีรัฐ	มณีรัตน์
รัชนีกร	รชนิกร
รัชนีกร	รชนิกร
วิรัติ	วิรัตน์
นินนาชัย	นินนาท
ธีระพินโย	ไชยธีระภิญโญ
ดร	ดร.
เอ๊	เอ้
สุชัชวี	สุชัชวีร์
เสรีพิสุทธิ์	เสรีพิศุทธ์
ลิ้มเจริญรัฐ	ลิ้มเจริญรัตน์
วัญชัย	วันชัย
วัญชัย	วันชัย
ต่อต่อ	ต่อๆ
เฟอรี่	เฟอร์รี่
เพชรชบูร	เพชรบูรณ์
เจนจิต	เจนจิตร
เสนานุษย์	เสนานุช
ลมเก่า	หล่มเก่า
เพชรชบูรณ์	เพชรบูรณ์
เพชรบูรณ	เพชรบูรณ์
พัก	พรรค
ธนทร	ธนาธร
ธนทร	ธนาธร
พัก	พรรค
แสงกระหนกกุล	แสงกนกกุล
รณวิทย์	รณวิต
พัก	พรรค
พัก	พรรค
อภัยภูเบศ	อภัยภูเบศร
ท้มท้วม	ท้วมๆ
อภัยภูเบศ	อภัยภูเบศร
การวิพากร	กานต์วิภากร
อินมียืน	อินทร์มียืน
จรรย์	จรัญ
หัดใหญ่	หาดใหญ่
จริงจริง	จริงๆ
พงพันธ์	พงศ์พันธุ์
ในทุน	นายทุน
ขวาวไร่	เขวาไร่
จับกลุ่ม	จับกุม
พงพันธ์	พงศ์พันธุ์
ส่วนที่กำลังกัน	สนธิกำลังกัน
จริง	จริงๆ
จริง	จริงๆ
นางลำ	นางรำ
ยิ่งรัก	ยิ่งลักษณ์
ชินวัฒน์	ชินวัตร
ยาลา	ยะลา
สารเจ้า	ศาลเจ้า
วัดต่าง	วัดต่างๆ
ดี	ดีๆ
ของว่า	ของไหว้
ทุก	ทุกๆ
หกร้อยเก้าสิบเอ็ด	691
ปารินา	ปารีณา
สป	ส.ป.ก.
ปรินา	ปารีณา
ปารินา	ปารีณา
ปารินา	ปารีณา
ปารินา	ปารีณา
ไกรคุบ	ไกรคุปต์
สส	ส.ส.
ภักดิ์	พรรค
ศิลปะอาชา	ศิลปอาชา
เนธิพา	เนติพร
ทองทรงวง	ทองทรงวงศ์
โขดทิมธาราม	โขดทิมทาราม
เนธิพา	เนติพร
ตลาดใส่	ตลาดไทร
เสาะไทยสงศ์	เสาะไธสง
ต่าง	ต่างๆ
อักษร	อักษรภัค
เพชรต้นพึ่ง	เพชรต้นผึ้ง
จริง	จริงๆ
ชื่นมื้น	ชื่นมื่น
ทั่วหน้า	ถ้วนหน้า
ขนขวาย	ขวนขวาย
นายกรรมตรี	นายกรัฐมนตรี
เมื่อไหร่	เมื่อไร
ผู้ทอง	ภู่ทอง
พี่นุษย์	พี่นุช
สนทิ	สนธิ
คูเวท	คูเวต
น้องคล้า	หนองคล้า
ภูวิลล่า	พูลวิลล่า
มีกง	มีคง
พระครูประสาท	พระครูประศาสน์
ไอ้นุ่ม	ไอ้หนุ่ม
ตื้อ	ตื๊อ
ฟัด	ขวัญ
วิสัก	วิศักดิ์
วัฒนศาส	วัฒนศัพท์
ภูมิในการ	ผู้อำนวยการ
อบต	อบต.
อบต	อบต.
อบจ	อบจ.
อบต	อบต.
อบต	อบต.
อบต	อบต.
อบต	อบต.
ปียบุตร	ปิยบุตร
พัก	พรรค
สออ	ส.ส.
ปียบุตร	ปิยบุตร
พาราดร	ภราดร
สส	ส.ส.
บุษบาล	บุษบา
ห้องหงมัธยาบีต	ห้องโถงพัทยาบีช
พระครูบาบุญชุม	พระครูบาบุญชุ่ม
น้องน้อง	น้องๆ
โพธาบราม	โพธาราม
นายง	นาโยง
สงกราน	สงกรานต์
วัดทัพกระดาน	วัดทับกระดาน
ขอเข้ามา	ขอขมา
45ชั่วโมง	4-5ชั่วโมง
เช	เชฟ
นายก	นายกฯ
วิสามัน	วิสามัญ
มช	มช.
โพทอง	โพธิ์ทอง
สาร	ศาล
พระขนง	พระโขนง
สปลาว	สปป.ลาว
บาน	บาล
ปริศนธรรม	ปริศนาธรรม
พราซ่า	พลาซ่า
รันตูปัญญัง	รันเตาปันจัง
กรันตัง	กลันตัน
อวดอุตลิ	อวดอุตริ
สุไงโกลก	สุไหงโก-ลก
รำเภย	รำเพย
พงศักดิ์	พงษ์ศักดิ์
ชวาง	ฉวาง
ชวาง	ฉวาง
บร่อหมาน	บรอหมาน
หมีนุ้ย	หมีนยุ้ย
คลองแห่	คลองแห
หัดใหญ่	หาดใหญ่
ถ้ำพันรา	ถ้ำพรรณรา
สมภาพ	สภ.
ชัยนัท	ชัยณัฐ
กรชายนัน	กรณ์ชายานันท์
ตู้เห่า	ตู้ห่าว
อินปิ่นปัก	อินทร์ปิ่นปัก
สุธิพัฒน์	สุทธิพัฒน์
สมสิทา	สมสีทา
นัดกมล	ณัฐกมล
สุเมษวัน	สุเมธวัน
ไว้อะไร	ไว้อาลัย
แซะโม	แซะโมะ
กิมลัง	กิมลั้ง
มัธิปิไข่	มัถปิไข
มีดพระ	มีดพร้า
จ้าละวัน	จ้าละหวั่น
สิบสอง	12
ไทยลำ	ไหหลำ
ยหา	ยะหา
สำนักงานประสุทธิ์	สํานักงานปศุสัตว์
ละนาบ	ระนาบ
ลุงนาง	รัง
ละนาบ	ระนาบ
มโนรา	มโนราห์
มโนรา	มโนราห์
ยหา	ยะหา
นั่งเดิม	ดั้งเดิม
เนี้ย	เนี่ย
ภูลพงศ์	พูนพงษ์
นายนาภากร	นัยนาภากร
นครพิง	นครพิงค์
นายอักรอมเลิศอริยพงกุล	นายอักรอมเลิศอริยพงษ์กุล
วิเชียน	วิเชียร
ถนอมวง	ถนอมวงศ์
ปวีนาหงษกุล	ปวีณาหงสกุล
ขมครู	ข่มขู่
พระดำ	มดดำ
สายัน	สายัณห์
อ้ำ	อั้ม
ยัน	ยัณห์
จิรษัก	จิรศักดิ์
อุทัยบัน	อุทัยบรรพต
คอนบุรี	ครบุรี
นี้รีน่า	ลีน่า
ข้อเก่าหา	ข้อกล่าวหา
ตรง	ตรงๆ
สลัก	แกะสลัก
ชีจันทร์	ชีจรรย์
อยากเรียก	อยากเรียน
เบิกบ้าน	เบิกบาน
56หมื่น	5-6 หมื่น
เธอ	เพื่อ
นาย10	นายสิบ
สี่สิบสี่	44
สายใหม่	สายไหม
ในมอส	นายมอส
ทุกผู้ชม	ท่านผู้ชม
ในหมู	นายหมู
รัศดา	รัษฎา
สิทธิ์คดชวัน	สิทธิคชวัน
ในหมู	นายหมู
ธนา	ทนาย
สิทธิ์คดชวัน	สิทธิคชวัน
รณรงค	รณรงค์
พลตำรวจรี	พลตำรวจตรี
หกหนึ่ง	61
วัดเจดีหอย	วัดเจดีย์หอย
ผาสุพงศ์	ผาสุพงษ์
แสนสุก	แสนสุข
นุษราพร	นุศราพร