
ตลอด	ตะลอน
หงหยก	หงษ์หยก
สุคุณา	สุขุนา
สุมนรัฐ	สุมนรัตน์
หนองคาย	mark
พง	พงศ์
กระเหลี่ยง	กะเหรี่ยง
สุมนรัฐ	สุมนรัตน์
เฉลิมพงศ์	เฉลิมพงษ์
สุคุณา	สุขุนา
ศรีบรรพฤษ	ศรีบรรพต
พง	พงศ์
ชมฮะ	=ลองฮะ
ลองฮะ	ชมฮะ
กะเหลี่ยง	กะเหรี่ยง
หกสิบหก	66
นายวิชิระแขทอง	นายวชิระ แขทอง
สิบเก้า	29
นายธนาวุฒิถาวรพราม	นายธนาวุฒิถาวร พราหมณ์
ห้า	5
นางสาวนิรนาศศรีพุทธา	นางสาวนิรนาท ศรีพุทธา
สิบ	10
นางระเวง	นางละเวง
ท่าแคร์	ท่าแค
โรงพยาบาลศิริกิจ	โรงพยาบาลสิริกิติ์
อภิษฎเวชาชีว	อภิสิทธิ์เวชชาชีวะ
แบงค์	แบงก์